R 1024 768
   F        155     ,     17   ,    30
    C     255     ,     192     , 255
WE ./textures/ROCKRED3.xpm
EA ./textures/MARBFAC2.xpm




NO ./textures/SKINEDGE.xpm
SO ./textures/MARBFACE.xpm






S ./textures/portal.xpm


1111111111111111111111
1022220000000000000001
1000000000000W00011001
1000000000111111111111
11111111111




